3222222221
1        5
3   442222
3   44   1
5        5
32222   23
5        5
3  4 4   1
3  4     1
3212352311